jtq: nrr nqb
jql: rxs rgl nsb
gmj: fhr cvd rdb fbz jcc
rdb: llj jzl
fmc: brd rkv dds
qmf: nhf xrh xxd nxl kvv
jqp: dtk fmj
jqk: fxp llf
ccz: kmx pcr vdx dbh rxd
hzx: mnf
tvv: ncq tdq
fpx: mgp tbx drv std
xhj: xxd nnk brj tgq jqq
hzl: dkz
xll: vqn tdv tch
vqn: kjt
sdp: qgr hxg vtj vpf
hks: cgx dmc
fzm: hbk tvb rnj
ppf: brd gdn jcc
mfq: kvl fbd mrx
kvs: gsm glq pkq vjh
crm: bmh qpg nsl gkq
vfx: zfx qvl zfr tml
qxc: ddj
qmd: glt zjb
gcj: lhr
jrg: zdk pcb bzv zjv
blx: nqd drv ttm pqx
jln: brp bxq
knf: jzj
pvn: zpp zvl qbx nnt
ksk: qks qmd lvf kkt ksg
bmf: skh mcl
kcj: fth qhf tdd cvb lbm rff
qbm: vkf ctx tzm pgl
bds: gzn slt
kjc: mtd xrt jnq tgb kxb
jct: hvh kvf jfx fkq cgz
xgp: nxl qkr sxn csh
bgg: ltv pnr
frp: hqp pvv bmf
nnx: hzk dpv nbs
hsn: jsm
rbd: thx cgf dbr cqx
lsj: vbr nfm mdd
sjc: zdf lnf
jdt: tpm ccv zpp
ktl: ntf bms tgl txf nrf
lsl: vrn cnb lgp
kpz: pxj nrr tns
ftd: zds jlt
hvm: cxz kfc pkm rqh qvl
gjz: jlt jds grh dth
tch: srh zqb
sgs: dgr pnx hcz
qhf: tbp
kfp: qtf vzg kfm lrd
tsr: grn tkd
fnp: kpg tbq vpv vxd
xfl: ssl ttz npx
srt: cnc rdx rdf
zsc: pcp tdm knz tgc ztl
tbx: nkq dbl qjl pth
stk: bhm cxq
qtl: jdv
hqg: rbj bng zpj lfv ksq hdk
tpb: nqd
tdv: zsl xcd
sbg: sss dnp lfd llb
lxp: pbk xcq
qps: dls mtr
lnd: dtk rzp vpn
pcc: vjh csh bmh tbp
svc: sdz fpr kpq
sjx: hlv qmh kzk grd
rgf: vcn jkm
kxh: nds hnl mhj nfs
jmh: tct hjq rxn qcg
hzg: ltz
jlf: xtt hzx gvg gjl chm dlt
cnk: ddb fvb lbs tnd
bzj: qzr pnk
hnf: mkd
plv: ttn xkh
rgt: dmj mdk ndz drv
pnk: ppf
vfh: fps pkm ssj pdl
zfj: hng
gnk: lpt shm pvn
ndz: knq
xcb: bgg qgj jkl
jkc: ndz jzj cng lzq
rrm: kfm tth
krj: nsb tbh bbp
qvl: zhx zqc
fkg: nvk
hfk: dxz pqj rhn
lft: vmz vdj jth dbj
tdq: nxl jth
vrg: hzg
fkj: bxc phk
lfv: hmc qdm
lgp: rsk krt
nqp: mbd lng
qhj: tkd
jjs: dgr lxp bnx dgj
ggp: nmm tlc gzn hgd fnh tth
cff: fjk pxj nvt
ttj: qfm sts qdr gbz
djh: gkb hjg
ftr: vmz rqf nzq pqm nxr mpg
nbh: lmq cng lpt
ssl: gdl
zvm: sjc tgn dhg qmh gvt
ggj: vls zbv
cch: mlz dlr
cmd: vsj kjt xlb rpm
skx: rbr ssd
bsr: mpl kmx ktr fjb ksq
rcn: njb
lkv: fkl rhl zvg nkc
lgd: frc rbr spx jlj bzj
nrf: vqs
sgc: ssv dhh fzm vmz fzl
gqq: vtk tnd
nlx: cgx
xct: tsr rzk lqj lgm
sqp: cmk qfx
bjg: nnz lhr
hmb: xfb tsr qtf qnx
gqn: xgx hxg glt fhr gqc
mmh: fps
lgh: ltg tgq zds bbd
zgv: qdm qjl cjb lpv
frk: sgk
mdf: pgr ccv phk
gxn: cgf nvk
sdf: dkr mnq
sxt: bmk kdj
dng: tbh rpm fbk
sjr: nfm tfv mjc
xxp: vfm xhp
kzr: fzb
dvt: hks fqg lgh
lpl: kng tth fnj cfz
cxk: szb bhp vkf zrz
rzl: nft hqg glm
xlx: zfr nmd ddk mpp fqb
ksx: phl tmr rpm jbz pxr fgc tfv
ghd: mgq xhp fnx
xbf: znf
qzn: rsf
lkx: hhf hnx tlx hbj
rpz: npm nts htk
zps: djb skq mxh
zmn: jmq hqp
lts: pxj xmj ppz nfq
jlk: pqt nbh nlk tnr rdp
bms: xcd lqt
brm: dxt xxn qxc nkj
lxg: zxm tpm
jxd: vgr cds gsm zxj
mlz: clk
pth: cnb
hlc: dqr jhg hnf
nns: rgc bds hch kkk
tvk: sss zxj krs
phl: rgf zrn
hjm: qfl vtk hsc
mgj: lfb mlx nnz cxb
dmj: djb fmn
npx: ktq ltg
qmh: dfx
pgk: jqq rdh dsj qnn hxj
lnr: gbl cjg gfz jqk
zsj: zfj fqt
brz: bpf qbd ftd qmf bmf
zhx: pds tnd dmm
qhg: xll cmk ppz srx
vfd: zln cdn
jmx: mnf bsq
dqh: nms fpr nkj
smg: glp ngt pnk
ztl: vcv mbc
pvk: rzk
jhm: gqq qtl ztl xml
rzr: rxk mdh
nzp: dpv mqg mjb pdf
ngb: fkl ctx dcq czx
tdc: dlt tbd
nqs: mps qlv ssx xbp hcn
pmd: fvr vmf gcd vvt
shq: rtm bpm bqc dkm
tgr: rbs txf ftx mcx rtm
grn: rjm nms
psq: fmj
ksg: kdk qzn hzx glt
bnq: ckl
jnq: hzx qpd hjl dcl xbk
zqb: frl
vlq: snh rpm
pkm: jkm
jpd: ltl drn gck bxc bkh
smd: dvt mbc hrz czx
slg: pds
dcs: dnh
gfz: zdj
kcb: dxz mfg jln
dxk: sgf bjf nzq fps scq
rzq: llh
xmx: kdt xbf kgb jjf
jds: rjh rgl jqq
zdx: npt
dqz: thx dqr
jpn: qhj jjf
rtf: hsn cjb vvt ghd
xcc: sdz xtt
jtx: qlm crb qxz
cct: dlv xgg dmp gsd
cbz: zvc dtv dkm qbd
jtk: qgr vnx xbp
vhz: fts tvx krj njb
hhq: nxb bsq fjn
qbx: qpd cxg
jfr: qzb vdf fzm frk
jzp: tvd rls lfb fqg lhs
cvd: qnx
pkz: fbk qnz
njs: fzl
mqb: gdl
mhs: vdx
bvd: fsg ldf
xmk: hzg mbd fpg fhr
dpv: lrk
szb: qpt bxt
fnj: qkl
mgx: ktr zll hvt
bpf: jmq htd
zst: sfh lxz zfl mgp
chl: gxn dcs
ddj: znl
bbd: pnx tfv
bph: ftx dxp dqq vfl mmd
blt: hjb djf rbl bmf
cvb: kft
bsh: qpm snm vqn njb
cmk: bcd
hdl: kfz dsf
jmm: qpm ttk
cqx: lxj tcf djh
ptp: kzv qgj rxk
rmt: vft ttk
bdk: mjl nfc xnd tll
jzj: rjq
fvp: vtk gqq rbl bst
hjl: jnx
xqk: qhd cbv
mpg: dth nnz sgp
lxj: vmh
rtb: slt
cfd: cdl
kbz: vmf njc lqn rgc
kmc: znx hbn
snf: fks kfz
bqt: qnz bmh pxr fth
qlm: dmm tvd
ptc: tzm
qmn: tvd
gmr: sfh rll psd cfz
jmq: kzr
rjh: pcx nxx
gdg: hjg zfl hqk dqh
fdn: jbt
vpd: rhn hng tcs
xzh: skh dnp
npp: qzn vxd kfv
tbh: vcn mdd
tpj: fnj mgq
pzb: xlz lvz ncq qfh
nft: bzv clk vpn
sqm: bbp zds
czv: dxp cdl nhf czt
zvv: mqv thm vsh
zrn: dmv fbk qfh
jtz: rvn vsh ldf
lnj: kzk zhj dzd grn
nmd: mnq nql bkc
nnt: mqv xbk blx
fzz: pkm fkc qkr fbd
xjb: dfh qcg dmj
qcf: dhq fqr lzq
ljg: mkk zvf xmj
qcd: kvl zqb cxz nsf
ntq: rxn lvf
grh: lfb
cds: kpz srh qgj
pdl: ppk dpj xcd
pxn: plv
zll: bng ddc pth
njc: rll hzx
pbm: mmd kks gmt ghj
dnp: mzp
grq: csq dqz tpb ckl
hsd: lmq xdv
sxs: pch ssv qfm lls kht
mqs: xcc vtj mhg qhj nlt
cbv: vdx thm
mhj: nvr mgq
pdf: xgx
cjz: cnz dkz lqt dmv
zfb: nzh lls mpp bgr
lfd: zsl ssj zds
dvg: hhv jhl
hnh: nxq vst lzq
kdk: dtn glm
dcr: tvx
hvh: vlh rmt svd
kxk: sbc sdp hsn shn dfx zvv hjj
kgb: glp gvk
fkq: jlt pxn
mdk: xrt ldb
nrm: mgp njc xdv gfz
fjb: rsf mxm
tbq: ktd jjf
fvr: bpk
dsd: vql sss
sgk: rxk lsz pcp
qzs: ksz mdd
fld: mfm mjc rff qhf
trb: zll trk
ltz: znf
jxv: hbs bbp ptc qkb
flk: ddc hrp rfr mbg
fjk: cxq hzn fbd
ljb: vpn nlk gkb cng
mgq: ltz
cxb: sxn
btp: lrk pxb snf mrv
gvt: rxn
drc: hcn mxm stg kkk npp pxs zfv rpf
msm: hlx trx xjp jrc
dkr: mcl
nxl: vzh
bxt: bql
kpg: htn
hrz: lbz mcx ljx
mcf: cfz dhq lhm glp
gft: bng qhd
bzc: lhb mfn dgx xcd
tmr: ddk dxz srr
xlk: shl chm tlc tpj
nfg: fvb xml vtk
zvc: qfx jkl
vvg: kks jhl
gdn: knf glp
rqk: kfv djh tkd bsd
qnn: rgf
fhq: dcr ftd rdf pnx
tmz: ttk
pcx: glb pnr
llr: jjn nfg gsd
ftv: ppz xvz vvv
jfs: kjh lxz krt zll
fkc: ftv krj xmc
rmr: qgf fts
lzq: hrd
fsg: thm
vqg: vfr xtt mpl
gqc: nvr shn
kct: lnf hpt frc dbh
ngx: pvk pgr
rkl: vrn hnf
ttn: mdh
zdm: fzm pnt kjm mcg qlg sfz
nhx: rbr
jmd: lkd bzj ggj mdf
hcr: gsd sqp kjd vtk
scq: ckz nrr nxp
hds: pxr mjc
dzj: mcl
ssj: stk zmr qzs lvn
jjp: lxp fqt tgq npt
qkr: zqc
nxp: dxr
bcx: bbm lpv zrx
rbl: vbc hzl
phm: tpm vdx nrt
jnk: vcn zfj ltj
zlc: dcs clf cvd
mrf: rjq
nlk: mqv kpq kgf dxt
zdj: hrd
cpb: gft glt lsl psq
rln: ffv vqs fqg sxm
xkp: mkh knk kcz vfr mjb
dqr: rsf
blz: zrv jdd bzx php
svd: vmt xrh
tnb: bgp hpv jrc bst
dch: qjl rzp lnj rpz
crr: nfs hjg hch
xfb: ltz bdb
kkz: lvn jmm lbs
pct: qfx mcb fsn
xgg: fqt
hbz: grd kng lvf
xdx: spg vtq zvc rcn
lhm: gvk tdl jtm
lkd: lct jnq rgt tkd kdt
dkm: pdl czv ltj
zpl: bdl rjm
dzd: xbf dfx rdp
cvs: mcg ppg nfq tml
mjm: hvl zzj qxc zgn
jzl: jtm jrh tpj
rqf: dgj tdd mfq
xjn: fth czh pft tbk
rls: vjh snh
sdv: dfh kfm
vbn: qkl kpq bkh lxz
ngm: mdd gjq nfm vmt
nvt: dvg bhm
fsl: tgn xsl vfm
dzr: fvr dsp
cdn: rtb
dmv: ltg
ckm: sqm bdt xcd rgl
phk: drv ltl
tkm: fsr
hcn: hrp
hdf: smh trk hkn lgp
fcr: pgk nxh mgv bxt trq
ktt: qkk hmj tbq xxn cgf
czr: lhs bvh nvt sxv gpm bbd
bst: jsj
hbn: mrv cxg
bht: vtv
tbk: gdl lbm mgr lfb
dhb: rtb grn hjl dcs knq
ccn: dxr
czx: tvd
brp: nkc tmc
zcj: jhg nnx phx
pcr: jsm
dmc: tkm jsj
kjh: smg jjd
mdp: rgf ztx zgf
ngv: sql xtj ttk qzv kvf grc
bhp: crq
gsb: fkc hgp dmv gkj
hjx: fzx rjq kkv
lcb: vhp vlm dpj rmr
qfg: rkl qks hnl zmd drv
mdh: vqs
rpf: gcd
qsj: bff grc dcj ckz
xzp: dtn vfm tvn
dxl: svc qpd gqn qxr
tpr: qkb
srr: nkc npz jnt
ngt: vbx vqz lmq
sql: tdv msr mfl
tlx: gqf xnz
zzp: mdp smt frk cgx
pdz: qlc nds vqz
nrz: xcb zfj gmt pch
jkl: pbk
dds: pxs nxb dkq
vrk: fkj kps jqk
cdq: bnq grd rrm dsf
mvd: gqd vkf qmn
xmc: gjd qfh
nxq: fks dsp
mcg: zdx
kjp: tdm pcp ljx srl mhz mmh
lng: fsg
lkm: qgj sxj ktq lsz
xgc: vjn pdz nlt qjn tfj
xlb: gkq czh
mmd: vvv rgl xvz
pzf: gsd dgr qhh xvz mjl
zgb: xjp
nzq: qzv rmt lcj ttn ktq
nds: gcd xjv bzr
dlz: rdf ntf ddk fvb
kdj: lvf jmx
hch: ktd hbt
sss: lbs qfh xgg
glq: rcj xnz vjh
mlx: trf sgs xkh gjj
fhk: zvg xlt mhz gcj
pgt: mbb czd hqt qgs std
bzx: hdl dnh fss
pqx: znl zrx
qfx: dpl
hsr: cdn fxp pcr jls
bbm: nbs skx
mfg: tzm spg
tml: qfm
sbd: dsd ksz bsh gqd
gsm: cmk cdj
zfx: jvr dvg pbk xgm
vnc: slg rxs
qlv: jjf hkn
mgr: vvg zxj pcp
pqt: gdn csq hfd
fpp: qhd kpm
ncq: kfc qkb
vft: dcr xlz
rvr: gqf dnp lhs rtm
bsx: ssd ptk tlj
ddc: pvk zdf qmh vss
clf: llj hbn
ttl: nkq hrd
jkm: npz
hzb: bht smh rpq vnh
bnt: pch dmc rxs sxm nfc
xbk: xgx gck
hxg: lpl
vdf: kcb bcn ltv mfg
hbd: rdb jmx gvg knq zmd
fbd: pqj
vdd: fvr znx
jzn: bgr rdh bql bgg
sbc: dlt
mnz: rjq
dsj: lhr krj
zcx: rgr vtk xlb jkm
dnr: sbg hng tcs ftj
hbj: npt ffv gmt ssl
blp: dsp zpk zmb pdk
sfl: fbk tgc clm pch bks
bgn: qfm rgf lqt
mld: kpg mbb fbz jnx
znz: gzz lnj nvk cnb
sjd: hrk kcd nqs
mbg: rtj bvd jtm rsk
bmh: npt
vlh: vcv
trx: rzb
dxt: vpv nvr
npm: xhp drf tkd
slt: rtj
rpv: zvg dmm skh
dmp: rgz nqb pzh
hpv: mfm
fdk: dsj xrr zjz
bqc: mcl kgs gmt
jdh: pkq frk jqq
rll: drn sfh mps
mfh: vsq csn qpd ltz
ztx: vql pkz
pqg: cmv xpz dxr sxs jlt
qzr: rbj
kjl: xrn nxb kzk ktd vdx cdn
lgs: hxg dzr kdt dhq
ssx: cxg
pcb: zxg dhb
mfb: lbv mqk mhs dhn php
bzr: tbd ltl
zmm: gfj gfz lxz qgs gzz
mgv: kzv tzm
ffv: mfn
rdp: mxm
mrx: vmn lqt
lcd: xzh ssl cff frp rjh
vbc: snm
cgz: ltv jll bpm nhf llb
rgr: sql csh qgf mpp
php: qkk lcg cnb
mpl: ngx hmc mnf
fpc: hvt qps kmx lxg
ctx: dth ssj
nlf: dmm sxm ddk hsc
gjq: cmk nrr vzh
jjm: kkk chl qps xzp
qxz: kjd fdn
xxj: vst drv
nrt: gzn fnj
qtz: gft gvt bzv
xxt: mfr nsv hfk gjj bff
hjb: gkj ddb mcg
gpr: ctx rdh jmm bhm
zgn: kmx
dkq: qzf jqp nnt
mpv: gfj flk nxq
lxz: rjm
mbd: dsp fss
zrz: qtl phl rzq fkq
rkb: vmf hnh fzx zrx
kfc: cvb
kjt: fbk
mqg: pvk
bdc: dhc grh jrc cgs bjp
lrd: lrk qtz hbz tvn dtp
fbv: hmc ttr hrk
hfg: brj vdj xvz sfz
gfl: fjb xsl vnh pdk
mjr: bgp
tgb: vpn mkd nff
rmv: gcd fmc lpl mps rzl
rdx: pds
shm: ptk rzk mnz
tks: hds xvz vlq jlb knc jnk
ckl: tjf jsm cxg fgx
nzc: xxp xqk hjx gns
kgf: fsl fpp sxt
zfl: kkh mxj
tvn: vrg cgf
zfr: nrr qbd
jhg: qnx
qxl: ttz cgc hlx mfl
rxm: mdh tmc cvb
mxg: qth ksb ztl
chk: svz qzr zxg
fsn: qmn dhh
fpg: rbr csq dlr
svj: rhz lhr smt mfl
htp: fks mkd xdv
hhf: jkl
rbs: srr xxd
qgf: pxn hng
nfc: pkq
ppj: spx mgp fmj kgb
vfl: bhp
lfb: npz
pdt: dtk pqt zdj cbl
jgz: xnq dbr bht rbb
drf: bds qjn
bdz: qnn gsd fzb bgr
tdl: nvr
rlb: kfc czx mqb tgs
zvl: qnx hjl
dgf: vbf htd
qlh: tjk jfx zmn cfd nsl
qlg: srl mkk xkh
dbj: zvg dxp bpm jkg
npg: mcg ftj zpq mgr
thm: chd
ksb: pvv stk khj
lnb: dng knd scc cgx hbk
nfs: jvs
sxj: czt
bzs: nxb nms kcz
lpv: lnf
zpq: kft srh
gbl: hsk rgc rtv
pkp: jjm fvg rpf
xqx: lrg pnf qcf smh
tfj: djb nlt bzm ntq rpj
djf: zrk slg pnr
kvf: txl
ppk: crb jvr
zkg: lng vnx
tvb: ssj sch fdn
vnh: nlt jdt
kpj: qxz zgb hzl fdn
gdl: llh
srx: qzv frl trf
mdz: mmh kft snm
xbl: hpv cnk ktp sbt
jsm: nhv rbf
vqz: kpm
ppg: scc smt ftv
xhp: ddj
knk: clk
qpv: jjd vjn kdt
hlv: lnd bnq cjn
cxn: dhq dsf sgb svz
rqb: bxt dvt vcv dcq
xgq: rtp vsq vkb vqz
csq: fjn
mjl: pzh
vzh: xlz
mlq: zxj jsj rjh ztx
dqt: cfd
fxp: tbd fmn
tbj: vns zpl qzn vfd
khj: xrh plv skz
qbd: pds
cdl: pbk lhb
bkc: dtv jhl hhf
hps: xnq htp bmk ssx
htk: ptk drv
qjc: qkb dgr tcs
gmd: mdk qdm vst
zjx: nsv zpq hpv
kvl: qpg nsl lhb
cfp: cjn sjc skq
xlt: rdf dgj mzp qnn
mnr: csq jqp
trk: fkt kzk lqj
ghx: fkg lqn xqk pdk zhj
nts: qkl kmc jgn
vrn: nhv mjb
dth: nqb dpj vhp
sgf: jpg sxj vbc
jvr: jfx
hxj: mdh
dgx: cmk ssv rls
rgd: pnh qmd qcf bxc
nsv: nfq
ljt: tkm cfd jql qhf
bzf: mms bgr
qgr: bzv
gpb: nqp blx ssx zfv
rxf: rpq hrp vmh knk pcb pmd nfs
fnx: vrf skx
dtn: nkj
rtv: xdb cvd kpg
fzl: rgz
dbl: lbv mxh
kbx: zbv
tcf: gfj
mcb: tmc knd nxp
bks: tnd sxn
rxd: sbc jvt
hbt: fnj szl
jcz: dqt tgc gbz pgl
lvk: lnf nmm xdd
spg: cxb clm tpr
ndl: knz mqb tkf
nkl: cbv
rhl: ndl vnc fgb zvf
xxn: csq bht
glm: mxm
vlk: dzr jcc pxm znx
ctn: nbs ksq tcf zkg
grv: vbx llj jnx
bzm: hzk fnx tjf
hhd: rbs hxj lkm
bxm: hgv dhc kjm fmf
hvt: cjn
cnp: kht lsj snh msr
zqc: pnr
xlz: nhf
fxl: vqs txl tgz tmz rzr
zjv: chd pvk
lrg: ltz mrv
bhs: hdl nqp hjl hll
dxz: hhv
cmj: fps qld rgz qhd
rbb: qjn kkv rtp
ddb: mdd
gdj: qdr pdl hnx gpm
gzz: dnh ntq bsq
gng: sdp ttl vrg bzv
tkf: hzl dkr sqm
gjh: hlc phs fgx zmb xgq ggc
gvg: rdp djb
pgl: pkz
snv: npz dkz mbc
mqq: jnr tfj dxl qpv
lhl: zpp svc
dlv: rxs
hll: qxs lpv vls
mcr: hds hbs dgx jtx hzt
qct: dst kcz bmk rsk mhg
zvg: xml
gfp: vqf
qdz: qbd ssj sbt
txv: lhl mrf cdn ckl
gqd: cmk
kfv: qdm
fgx: tgn vdx
glp: vpj std
tll: gjd npz fmf
llz: kvl blg bbp lcb
kcd: dsp jvs jlj
vmf: mtr
drv: cvd
frx: sdv jrh psq bvd
qbh: vqf gsv htk
lvz: jmm kvf nvs
mtd: mlk gkb qks jtz kjh
qks: ssx
knz: sxj
nnz: gkf
scc: kht
bsc: ttn mvd dzj dng qtl
qpg: nxp
blg: brj pzf kvs kjk sqm
hgv: nlx hhf
tgs: fvb gdl
xgm: qss jln kgs
zfs: qxc spx htc spm
chm: hrk tlc rvn
ddp: srt vvg
kkh: rbr vrf shn
zvf: xjp vlm
mfr: rdx mpp vlh xmc
cmv: zgf
pvv: fll njb
qdr: dkz xtj
ttr: vrf vpv kfm
mms: srh jtq jsj
jbz: bhp srl
fvg: jgn dcl
pxs: htn gxn
sxv: gqd srh hgf
vgr: dth glb zqb phj
glt: mlz
znx: zxm
pxj: kgs tgs
jnd: xrh nnz
fmf: fbk
nff: lbv
sts: jnd slg jtq rgl dcr
ldf: vqf zmd
cvj: cng fnx
fjd: pss
bvh: jnd dqt nzq
jtm: tjf nvr
qgj: gcj
skz: vhp sxm npx
phs: llf fvr tbx
zrp: lcg tdc rxf zrv
cnd: vmf ddj xbp
pxm: cnd tsr bpk qgs
qzx: xnz fdk pmr bxt
hdk: fvr vqg xjb
ltv: vkf rcn dxr
vss: svz kdj
cvp: llr nxr dqt vlm ktq
phb: vmn vfx qfl rxm
fqr: hrp kbx
xrt: vkb tpm
phh: ghj fzl tvx mkk sjr zgf
phx: drn djb knk
nxb: fpp tlj
dgl: vdd fpr vqf
mfl: kjm
vtj: cfz rzk vrg
fgc: bql nfc ktp
jsk: trb hnh zps zlc
vbf: bjg rcn nzh pcx
drn: znf
jhq: vft jbt
msp: psd vfr zdj xvh rbj
glh: bdb grv fpc sdz chk
dls: fkg tdl
bzb: mfm vcg nlx nfq clm tvv
mzf: tvx cct cnc fkl jth
vvt: bds
ckj: pcr nvk dfh grf
rbf: vpv
nsl: qhf
kdt: qlv
dtp: hrp
mhg: rtb
ljf: qth vrs szb lcj
gsv: hrd lmq rpf
cql: clk
gnf: vss gmd lvk mgx xvh
skh: mzp nxr
hpt: sxt cng bnq
rnj: txl pvv kht
jll: lnf gkf
qpt: sfz
hgp: xzh knd tvb
msv: zdk ckl hsd jdt
vxd: smg pdf gqc
cfq: zmr hjb ckz cmv
fkl: qzs vfl
crb: rzq
knc: csh nsb tlx
ftl: qfh hsc bcd hzt xcq
czd: brd
trf: vjh hks sxm
rkv: zpl zpj dtp
ljx: dkr
qtf: lqj skq
xmm: vmh mhs skq thx
kcz: cnb
lbv: vjn
ztm: vjn gfp gkb mnr
lsr: vvv lhn vmn xgs
nvs: ttz pvv bhm
pcz: vqg qhj chd hnl fmn htc gfp
sxn: qpm
ccv: fss jzj
kjm: vqs
fnh: lvf vqz zmd rsf
xpz: nzh nxp krs vvv
fbz: ldb szl tbd
trq: dlv plv pgl
nmm: kfz hfd
vcg: rjh fqg
znl: zrx
nss: tzm sdf gkj qhf
dtv: ngz
vsh: lxz zgn zbd rkl
kzv: rxs
nqj: zsj qgf qjc jkg lsz
krt: xcc cfp bpk
rlv: hvl knf bcx cgj
vpn: xxp cql
smt: kft nsv pnx
bxb: xfb lgm snf zjv
cnc: fqb
tgx: jdh sqp bzb fkl
xmj: czt jhl
fks: fss lmq
xzv: dkz tns
ghj: pnr tvd
lfc: lxp tvk hvm bzf
kqr: npt
nql: dvf vlq tdd
lsv: frl jvr kjd mrx pct dlv
rff: njs ljx pqj bxq
zxj: xkh
cqc: lqt pzf bjg ksz
qxr: vpj pxb
kpq: fbv
nhv: dbr
cdj: vkf gqd mnq
pgr: std
zsl: pbk dnp
rqh: pkz bxt zgb
qjn: lgm
vls: kng
jkg: rzr
kdp: mfn xml dkm nsf
xjp: clm
grd: rkl zkg
ktr: dlt
tcs: xcq
cbl: chd
dcj: tfv bck gjj
lbz: bnx bms
jfx: cxb
pfx: nff vrk dgl vdd
nxx: vmz ngz mcx vql
bjp: dgx bql zmn
xdd: fsg bdb qxs
tgz: vbr rzb fts
zzj: kmc rcb ttr
ntf: lls bkc
zdk: rrm lxj
dss: dqz fkt mnz cjg shn
zjz: hzn lbs knd
xsk: cql qcf qqf bzr
tlm: ltj ccn dsd glb
hnx: snm npx nrf
hjj: hzg
xgs: dvf ddv tgz
rnr: slt hsd zxz ktd
dhg: vzg hjj zzj
lvn: lcj qpt
dqq: rmr bck crq xcq
pmr: kzr ljg vtq qkr
bdt: vhp fts trx
cgj: drn cch
skd: kkh nzp hkn dfh
grc: xrh rqf
lhc: vfr ngt bxc kdb
fhc: zxz fcd drf xhr knf trb gvk
gkq: mfm kht
sgp: gkj qfl dkz
bdl: jzj hrk
jlj: llj sjc rgc
zmb: rfr sfh
mcn: hhq fzx fjn kkh
qzb: npx tch grh
zln: ttl vkb mnf
pgn: hbk lls kjd gqd sdf
lhs: lsz zdx
kxb: bdl ssd kbx
dcl: frc dbl rjm mhg
qss: pcx ttz
stg: cqx ngx cbl
xsl: lvf dxt
mtr: tpb
gnm: hnx tdd xxd pxr hcz
ttm: rtb tpb sdv
bgp: nnz mqb
dhz: vft cxz lhz
kkt: kkv hsd tbx
rhz: xnd czt bjf
hqp: zqc
pss: qfl gkf
zkh: vzh ktp skh nfc zmr
jjd: qcg
zrs: tgc bxq dkz khj
lbm: bxq
jdv: hhv nqb
gsk: zvc dvf glb xzv
nsf: jnt kgs tdq hbs
grf: llj vpv mgp
tnr: hjg kbx cfz
sjn: hgv nxp lhz ngb
bcf: zxm xbf dls ttl
vzd: bql dmc bjf njs cnp
bff: tzm qzv
vrs: tpr tjd
rcj: nnk cxq hsc
rtp: dtp zdf bmc
xdb: xxj zfl vnx
jjn: bmh vpd crq
dtk: mjb
kks: pzh
rdh: dhh
svq: ltv hbj dvf fkc
dph: bst qth jth ztl
xrn: jnr xjv xxj
cgp: gmq kps dch nrm
hqr: mqb rbs ddp jfx
bsf: lxj sjd dfx jtk
jvt: lxg xbp rxn frc
nkq: jhg mtr
psd: kng
hvl: bhs brd ckl vfd
vfj: tcf gzn mps vfm
vsj: txl snh fmf sts gpl
rvn: szl rfr
cfj: hsn brd jvs rtj
rpj: lfv vss mnf
dcv: pqm xll tvv bpf
sgb: nqs hbn jnr
mxj: nkq cjn nhv
jdq: bbm qbh kkh mkd crr
gmq: kdk hnf svz
zhn: jbz fdf qld cmv
tjg: mrv csq qkl
pft: pzh jsj
htd: hxj dpl
tdm: cnc dpl
hqk: qcg
tct: sxt nms lnf
jzr: hbk gpl rzb kzv
pnf: nqd
shl: zzj bkh xdv bng zxz
dxp: vlh
ncn: fcd lpt fbz cgj
hgf: pss ckz xfl tml mcx llh
ptk: lbv
vcr: lbv znx zgn hjg
csn: gck hbt xtt ttl hcn nkl
lhz: gqf qnz
mhz: mjl
hzk: cjb
fkt: vjn htc
qjl: hcj
jrh: vmh
ltl: lpv
ftj: zgf npx
jfj: mpv mhj jnx mqg
hqt: pqx vzg sbc
xlr: mgv fjd ppk
rgn: hqp rpv knz gdx
vsq: vbx htc
vsp: hhv nsb crq kzr
gpm: fzb jlt kvv tns
fll: smt sdn jll
ttz: rhn scc tgq
pxb: lmq gck
nkv: fqt lvn tpr zjx
ntt: cvj lld vnx lng
cgs: bcn ccn pvv ksz
bkh: czd cbl
pll: mmh pds brj
hmj: cbv bpk vvt qgs zxg hvt
ccr: pkp qqf pgr cvj
mkh: mnf xxj
lms: sdz vrf hgd hjq
jrc: vmn
ssd: nfs
kvv: kgs
qhh: brp qkb
zrf: ltz tdl ptk jzl
rcl: xjb rxd vns fqr nqd pkp sjc
nxh: zmr kzv sfz
cnz: kjd mnq vsp
dhc: lvn gjd nkc
bvq: slt vdx clf lng
xtj: sdn tjd
kmx: psd
hjq: zkg fmj
bvg: fkj zzj pdf pnh bmk
gns: sbc xhr qlv
vtv: xnq
pnh: sbc ktr
pnt: ltj qlm frl
lcg: hvt zbv
vzg: mqg dxt
tlr: csn rcb jjd gbg
hcj: kbx gvk
vtq: ltg kqr
nlt: xnq zjv
hcz: bcn kqr
frm: lpv tkd mnz kpq
smh: kkk skq spx
dlr: gfp
jpg: pnr zrk hpv kzv
jqq: cxq
srh: scc bhp
sbt: fqb
dst: dls htn knq
rtm: sch dgj
jnr: mxh
fpr: lpt
hgd: zll zdk
ffh: pll sbt ccn jnt
xcq: xgg
hzt: fsr dgx
bck: bcd qmn
jls: fhr qxs
qzf: kpg mrf hqk
bnx: vcv tkm
nfm: npt
hhk: qdz tjk bgn llb vcg
ngz: bbp
fgr: dgf jkg jnl gjd xzv
lld: lbv kpm zpp
mbl: xlr snv dpl vfl dtv ffv zpq sch tbp
rhn: vbc
jtt: zsj mms krs sdf
qlc: qhd bzs hmc
dnq: ddp vlq zgb tbp
vjh: nsb
zxs: fnx thx zvl
ddv: vrs qmv ppz
vst: mbd
hsk: kbx vqf knf
mmz: pth zxg lgm mnr
mqk: pxs dhq xhr
gjj: mbc tns
tjd: vql
jpc: fqx qhd hch kmx
nln: fnx ggc vpj fmn
qld: tjk zdx
bjf: qpm srt lls
bjz: fjb mxh bdb rfr
kps: dbr rbr
kxm: szl mbb znl xhr vqg
qgs: qxr vkb
mlk: glm rfr htk
zrv: bmc tjf
phj: tvd krs mqb
lqj: gvt
gbg: nkl dsf pnf
qqf: ltz qgr tlj rpq
nzh: tmc cxb
kgd: ctx trx dhz vsp
rbj: qhd
lct: zrx cql
fcd: htp jls
cxz: fth ssv
zdn: gqf bcn tmz tdv
kkp: dkr dpj lcj mjr vtv
dgr: llb
cdc: qdr kbj ngz zrk svd ptp
rpq: dtn
vpf: bdl vsq mgq
zbd: lct nff fkg tdc
mkd: bsq
gbz: kjt jll
rgz: mjc
jgn: rfr kfv
cjg: pnf nbs
lrk: nhx
xnd: bcd ptc
fgb: tgr hsc lbz
lqt: kks xcb
mbc: txf
xvh: pnk hvt
cgc: dzj npz njs
fdx: vnc cdc gqf jhq
nnk: mdz tjd
dhn: bbm phx hcj pmd
zpj: dnh cgf rcb fss
hzn: bks ftx
bmc: htn
tcb: sgk xnz fjd dzj
fxs: nhx mqv mbb jpn
dbh: nkl thx glt
zsv: mzp vmn bzf bgr
gjl: hpt ztm fvg
zfv: ksq zxm xjv
nxf: rzp kkv nbh gjl
bsd: hzk bmc hjj
snj: hqk tjg lpt xgx zbv
qmv: dmv vqn mjr fqb
tcj: kks njb svd mxg
bpm: ddb
msr: txf
hlx: nlx fsn
vdj: nxr qnz
xjv: nrt
kjk: zqc nrf qpt
hmc: kfz sbc
xcd: hqp
sdn: vcn
skq: rbf
rzp: tgn
sch: cnc
zjb: qkl vls ndz
gdx: pkq rzb gkf
spm: rlv mkh zcj
qkk: svc rrm fjn
jlb: dgf cnk nvt
llf: zdf vpj
tth: znf vbx
vbr: tnd nhf
jcc: cjb
dzk: mkk msr jdv hhd
vns: czd cch
zxk: cdl rzq tmz
lfl: fkj qzr bsx chl gnk
cms: rcb dqr phm lhl
rsk: jvs
hfd: hkn nhx
vck: xgq jpn fzx mhs
ktp: cdl
bgf: cqx dlr lrg rtj
vlm: rxs
czh: kkz vcn
jdd: dpv zxs ggj
jbt: bcn tbp
lhn: jhq bxt sbg
vvm: cgx dhh fxl sdn
jnl: tch rhz zrk ptc
gkf: mdd
pdk: rbf cch
ldb: kpm nkj hbn
tjk: qgj
pqm: qkb vvg
zpk: zjv jrh zxz hnl
vmt: txl jmq
xbp: nvr ldf mrf tlc qxs
zhj: pxs ndz
fdf: jnd pft hfk
lqn: gfj vtv
fqx: rpf crr psq tlj
kfg: dcq xcd qpg xml
tgl: mhz bpf mjr
xrr: jnt jhm tlx
ftx: lhb kqr llh
ggc: jls mlz
hvn: fsr qss gjd crb mfn
qth: nhf
kbj: mcl hcz rxk
dcq: hjm
srl: mdz
pqj: gcj
zfg: zxk fsr fzb pxn rdx
hbs: fjd
kdb: fss bsd qbx
gpl: lbm kvv qhh